# # # # # # # # # # # # # # # # # # # # #
# # # # w w w w w w w w w w w w w # # # #
# # # # w v v v w , f S w l l b w # # # #
# # # # w 4 5 , w , 1 , w , 2 , w # # # #
# # # # w , , , w , , , w , , , w # # # #
# # # w w w + w w w + w w w + w w w # # #
# # # w , , , , , , , , , 9 , , , w # # #
# # # w , , 5 , , , , , , , , , , w # # #
# w w w , , w w w w + w w w w , , w w w #
# w t , 9 , w s c , , , l , w , , l b w #
# w t , , , w , c , 1 , , c w , , , , w #
# w t B , 3 w , , , 1 1 c c w , 6 2 b w #
# w t , , , w c e , , , e , w , 9 , , w #
# w w w w w w w e w + w e w w w w w w w #
# . . w , e , , e , 1 , e , , e , w . . #
# . . w , e , , e , , , e , , e , w . . #
# . . w w w w w e w + w e w w w w w . # #
# . . . . . . w e w . w e w . . . . . # #
# # # . . . . . T . . . T . . . . . . . #
# # # # . . . . . . . . . . . . . . # # #
# # # # . . . . . . . . . . # # # # # # #
