# # # # # # # # # # # # # # # # #
# # # # # v v v v v # # # # # # #
# # # # # f . f . f # # # # # # #
# # # # # d d d d d # # # # # # #
# # # # # d d d d d # # # # # # #
# # # # # # # + # # # # # # # # #
# # # r r r + . + r r r # # # # #
# # # r r r # . # r r r # # # # #
# # # r r r # . # r r r # # # # #
# # # # # # # . # # # # # # # # #
# # l l l l # . # r r r r # # # #
# # . r r . + . + r r r r # # # #
# # b r r b # . # r r r r # # # #
# # . r r . # . # r r r r # # # #
# # # # # # # . # # # # # # # # #
# t c h h h # . # c c c c c # # #
# . c h h h + . + h h h h h # # #
# . c h h h # . # h h h h h # # #
# . c . c c # . # c c . c c # # #
# . . . c c # . # c c . . . # # #
# # # # # # # + # # s s s s s s s
# # # # # # e E e # s s s s s s s
# # # # # # e E e # s s s s s s s
# # # # # # e E e # s s s s s s s
# # # # # # e E e # s s s s s s s
# # # # # # # # # # # # # # # # #
