# # # # # # # # # # # # # # # # # # # # #
# b . b # # # v v v v v v v # # # b . b #
# . r . # # # . f . f . f . # # # . r . #
# l . l # # # d d d d d d d # # # l . l #
# # + # # # # # # # + # # # # # # # + # #
# . . . . . . . . . . . . . . . . . . . #
# . . . . . . . . . . . . . . . . . . . #
# # + # # # # # # # + # # # # # # # + # #
# l . # l h h h h h . h h h h h l # . l #
# r r # . h h h h h . h h h h h . # r r #
# r r # . h h h h h c c c . c . . # r r #
# r r # . h h h h h . . c . c . . # r r #
# r r # . c c c c . h h h . c . . # r r #
# r r # h h h h . . h h h . h h h # r r #
# r r # h h h h c . c c c c h h h # r r #
# l . # h h h h c . . . . . h h h # . l #
# # + # . . . c c c c c . . c . . # + # #
# l . # l . . . . . . . . . c . l # . l #
# r r # # # # s s s s s s s # # # # r r #
# r r # # # # s s s s s s s # # # # r r #
# r r # # # # s s s s s s s # # # # r r #
# e e # # # # s s s s s s s # # # # e e #
# # # # # # # s s s s s s s # # # # # # #
