# # # # # # # # # # # # # # # # # # # # # # # # # # # # # # # # # # # # # # # # # # # # # # # # #
# # # # # # # # # # # # # # # # # # # # # # # # # # # # # , , , , , , , , , c c c c # # # # # # #
# # # # # # # # # # # # # # # # # # # # # # # # # # # # , , , , , , , , , , , , , , # # # # # # #
# # # # , , # # # , , , , , # , , , , , # , , , , , # , , c , , , , , , c , , , c c # # # # # # #
# # # , , , , # # , , , , , # , , , , , # , , , , , # , , c c , , , , , c , , , c c # # # # # # #
# # , , , , , , # , , , , , # , , , , , # , , , , , # , , c c c , , , , c , , , , , # # # # # # #
# # , , , , , , # , , , , , # , , , , , # , , , , , # , , , , , , , , , , , , , , , # # # # # # #
# , , , , , , , # , , , , , # , , , , , # , , , , , # , c , , , , , , , , , , , , , # e e e e e #
# , , , , , , , # # # + # # # # # + # # # # # + # # # , c , , , , , , , , , , , , , # , , , , , #
# , , , , , , , # . . . . . . . . . . . . . . . . . # , c c c c c , c c , c c , c , # , , , , , #
# , , , , , , , + . . . . . . . . . . . . . . . . . + , , , , , , c , , , , , , , , + , , , , , #
# , , , , , , , # # # + # # # # # + # # # # # + # # # , , , , , , , , c , , , , , , # , , , , , #
# , , , , , , , # , , , , , # , , , , , # , , , , , # , , c c , , c , c , , , , c c # , , , , , #
# # , , , , , , # , , , , , # , , , , , # , , , , , # c , , , , , , , c , c , , c c # e e e e e #
# # , , , , , , # , , , , , # , , , , , # , , , , , # c c , , , c , , c , c , , , , # # # # # # #
# # # , , , , # # , , , , , # , , , , , # , , , , , # c c , , , c , , , c c c , , , # # # # # # #
# # # # , , # # # , , , , , # , , , , , # , , , , , # c c , c c c c , , , , , , , , # # # # # # #
# # # # # # # # # # # # # # # # # # # # # # # # # # # # c , c c , , , , , , , c c , # # # # # # #
# # # # # # # # # # # # # # # # # # # # # # # # # # # # # , , , , , , , , , , , , , # # # # # # #
# # # # # # # # # # # # # # # # # # # # # # # # # # # # # # # # # # s s s s s s s # # # # # # # #
# # # # # # # # # # # # # # # # # # # # # # # # # # # # # # # # # # s s s s s s s # # # # # # # #
# # # # # # # # # # # # # # # # # # # # # # # # # # # # # # # # # # s s s s s s s # # # # # # # #
# # # # # # # # # # # # # # # # # # # # # # # # # # # # # # # # # # s s s s s s s # # # # # # # #
# # # # # # # # # # # # # # # # # # # # # # # # # # # # # # # # # # s s s s s s s # # # # # # # #
