# # # # # # # # # # # # # # # # # # # # # # # # # # # # # # # # # # # # # # # # #
# # # # # # # # # # # # # # # # # # # # # . . h h h h h . . c c c c # # # # # # #
# # # # # # # # # # # # # # # # # # # # . . . h h h h h . h h h . . # # # # # # #
# l l l l l # l l l l l # l l l l l # . . c . h h h h h c h h h c c # # # # # # #
# . r r r . # . r r r . # . r r r . # . . c c h h h h h c h h h c c # # # # # # #
# b r r r b # b r r r b # b r r r b # . . c c c . . . . c h h h . . # # # # # # #
# b r r r b # b r r r b # b r r r b # . . h h h h h h h h h h h h h # # # # # # #
# b r r r b # b r r r b # b r r r b # . c h h h h h h h h h h h h h # e e e e e #
# # # + # # # # # + # # # # # + # # # . c h h h h h h h h h h h h h # E E E E E #
# . . . . . . . . . . . . . . . . . # . c c c c c . c c . c c . c . # E E E E E #
# . . . . . . . . . . . . . . . . . + h h h h h h c . . h h h h . . + E E E E E #
# # # + # # # # # + # # # # # + # # # h h h h h h . . c h h h h . . # E E E E E #
# l r r r l # l r r r l # l r r r l # . . c c . . c . c h h h h c c # E E E E E #
# . r r r . # . r r r . # . r r r . # c . h h h . . . c . c . . c c # e e e e e #
# . r r r . # . r r r . # . r r r . # c c h h h c . . c . c . h h h # # # # # # #
# b r r r b # b r r r b # b r r r b # c c h h h c . . . c c c h h h # # # # # # #
# b r r r b # b r r r b # b r r r b # c c . c c c c . . . . . h h h # # # # # # #
# # # # # # # # # # # # # # # # # # # # c . c c . . . . . . . c c . # # # # # # #
# # # # # # # # # # # # # # # # # # # # # . . . . . . . . . . . . . # # # # # # #
# # # # # # # # # # # # # # # # # # # # # # # # # # s s s s s s s # # # # # # # #
# # # # # # # # # # # # # # # # # # # # # # # # # # s s s s s s s # # # # # # # #
# # # # # # # # # # # # # # # # # # # # # # # # # # s s s s s s s # # # # # # # #
# # # # # # # # # # # # # # # # # # # # # # # # # # s s s s s s s # # # # # # # #
# # # # # # # # # # # # # # # # # # # # # # # # # # s s s s s s s # # # # # # # #
