 ##+##
##...##
#p.C.p#
#p.s.p#
#######